1	W AH N
14	W AH N F OW R
1N	W AH N EH N
2	T UW
24	T UW F OW R
3	TH R IY
337A	TH R IY TH R IY S EH V AH N EY
337A-EVIL	TH R IY TH R IY S EH V AH N EY IY V AH L
346E	TH R IY F OW R S IH K S IY
35A	TH R IY F AY V EY
4X4	F OW R EH K S F OW R
5150	F AY V W AH N F AY V Z IY R OW
5C077	F AY V S IY Z IY R OW S EH V AH N S EH V AH N
5C077-EVIL	F AY V S IY Z IY R OW S EH V AH N S EH V AH N IY V AH L
9001	N AY N Z IY R OW Z IY R OW W AH N
A	AH
A(2)	EY
ABANDON	AH B AE N D AH N
ABBESS	AE B AH S
ABDUCTION	AE B D AH K SH AH N
ABDUCTION(2)	AH B D AH K SH AH N
ABOND	AH B AA N D
ABOUT	AH B AW T
ABSOLVE	AH B Z AA L V
ABSOLVE(2)	AE B Z AA L V
ABYSSAL	AH B IH S AH L
ACADEMY	AH K AE D AH M IY
ACCESS	AE K S EH S
ACCORD	AH K AO R D
ACTION	AE K SH AH N
ADAPTOID	AE D AH P T OY D
ADULT	AH D AH L T
ADULT(2)	AE D AH L T
ADVANTAGE	AE D V AE N T IH JH
ADVENTURER	AE D V EH N CH ER ER
ADVENTURER(2)	AH D V EH N CH ER ER
AEDILE	EH D AH L
AEMBER	AH IH M B IY ER
AEMBERLING	AH IH M B IY ER L IH NG
AEMBITRAGE	AH IH M B IH T R EY JH
AEMBROSIA	EH M B R OW ZH IY AH
AERONAUT	EH R AH N AH T
AGAINST	AH G EH N S T
AGAINST(2)	AH G EY N S T
AGENT	EY JH AH N T
AGUNG	AE G AH NG
AIRLOCK	EH R L AO K
AJA	AY AH
ALAKA	AE L AH K AH
ALAKAS	AE L AH K AH Z
ALERT	AH L ER T
ALI	AA L IY
ALIEN	EY L IY AH N
ALL	AO L
ALLIANCE	AH L AY AH N S
ALLIES	AE L AY Z
ALLIES(2)	AH L AY Z
ALLUSIONS	AH L UW ZH AH N Z
ALMSMASTER	AE L M Z M AE S T AH R
ALMSMASTER-EVIL	AE L M Z M AE S T AH R IY V AH L
ALTAR	AO L T ER
ALTRUISTS	AE L T R UW S T S
ALTUM	AE L T AH M
ALYS	AE L IY Z
AMBASSADOR	AE M B AE S AH D ER
AMBER	AE M B ER
AMBERFIN	AE M B ER F IH N
AMBERHEART	AE M B ER HH AA R T
AMBERLUTION	AE M B ER L UW SH AH N
AMBERMANCY	AE M B AH R M AE N S IY
AMBERSPINE	AE M B ER S P AY N
AMBERTRACKER	AE M B ER T R AE K ER
AMBROSIUS	AE M B R AH S IY IH S
AMBROSIUS-EVIL	AE M B R AH S IY IH S IY V AH L
AMMONIA	AH M OW N Y AH
AMPHORA	AE M F ER AH
AN	AE N
AN(2)	AH N
ANAHITA	AH N AE HH AH T AH
ANALYSIS	AE N AE L IH S IH S
ANALYST	AE N AH L IH S T
ANAPHIEL	AE N AH F IY L
ANCIENT	EY N CH AH N T
ANCIENT(2)	EY N SH AH N T
AND	AH N D
AND(2)	AE N D
ANGA	AE N G AH
ANGER	AE NG G ER
ANGRY	AE NG G R IY
ANGWISH	AE N G W AH SH
ANIMATION	AE N AH M EY SH AH N
ANIMATOR	AE N AH M EY T ER
ANKYLO	AE NG K AH L OW
ANNIHILATION	AH N AY AH L EY SH AH N
ANNOYS	AH N OY Z
ANOMALY	AH N AA M AH L IY
ANTENNA	AE N T EH N AH
ANTIQUITIES	AE N T IH K W AH T IY Z
ANTONY	AE N T AH N IY
ANVIL	AE N V AH L
APE	EY P
APPRECIATION	AH P R IY SH IY EY SH AH N
AQUILIA	AE K W IH L Y AH
ARCANE	AA R K EY N
ARCHAEOLOGIST	AA R K IY AA L AH JH IH S T
ARCHIMEDES	AA R K AH M IY D IY Z
ARCHIVES	AA R K AY V Z
ARCHIVIST	AA R K AY V IH S T
ARCHONIS	AA R K HH OW N IY Z
ARCHONS	AA R CH AO N Z
ARDENT	AA R D AH N T
ARHI	AA R IY
ARISE	ER AY Z
ARISTOTLMIMUS	AE R AH S T AA T L M AH M AH S
ARM	AA R M
ARMADRONE	AA R M AH D R OW N
ARMADRONE-EVIL	AA R M AH D R OW N IY V AH L
ARMAGEDDON	AA R M AH G EH D AH N
ARMOR	AA R M ER
ARMORSMITH	AA R M ER S M IH TH
ARMORY	AA R M ER IY
ARMSMASTER	AA R M Z M AE S T ER
ARRAY	ER EY
ASP	AE S P
ASSAULT	AH S AO L T
ASSERT	AH S ER T
ATOON	AH T UW N
ATTENDANT	AH T EH N D AH N T
AUBADE	AH B EY D
AUCTION	AA K SH AH N
AUCTION(2)	AO K SH AH N
AUGUR	AO G ER
AUGUR-EVIL	AO G ER IY V AH L
AURA	AO R AH
AUSTERALIS	AO S T IH ER AH L IY Z
AUTO	AO T OW
AUTOCANNON	AO T OW K AE N AH N
AUTOMATA	AO T AA M AH T AH
AUTOMATON	AO T AA M AH T AA N
AUXILIARY	AA G Z IH L Y ER IY
AUXILIARY(2)	AA G Z IH L IY EH R IY
AVALANCHE	AE V AH L AE N CH
AVENGING	AH V EH N JH IH NG
AVID	AE V IH D
AWAY	AH W EY
AXE	AE K S
AXIOM	AE K S IY AH M
AZURE	AE ZH ER
B0	B IY Z IY R OW
BABBLE	B AE B AH L
BABBLING	B AE B AH L IH NG
BABBLING(2)	B AE B L IH NG
BACKUP	B AE K AH P
BAD	B AE D
BADGE	B AE JH
BADGEMAGUS	B AE JH EH M AH JH AH S
BAIT	B EY T
BALANCE	B AE L AH N S
BALDRIC	B AE L D R IH K
BALL	B AO L
BALLCANO	B AE L K AH N OW
BALLISTEGO	B AO L IH S T IY G OW
BANE	B EY N
BANGBANG	B AE NG B AE NG
BANISH	B AE N IH SH
BANK	B AE NG K
BANK-EVIL	B AE NG K IY V AH L
BANNER	B AE N ER
BARB	B AA R B
BAREHANDED	B EH R HH AE N D IH D
BARN	B AA R N
BARON	B AE R AH N
BARON(2)	B EH R AH N
BARRISTER	B AE R IH S T ER
BARRISTER(2)	B EH R IH S T ER
BASIN	B EY S AH N
BATARIEL	B AE T AH R IY L
BATDRONE	B AE T D R OW N
BATTLE	B AE T AH L
BATTLEFIELD	B AE T AH L F IY L D
BATTLEGROUND	B AE T AH L G R AW N D
BATTLEVANGELIST	B AE T AH L V AE N JH EH L IH S T
BAUBLE	B AO B AH L
BAUTREM	B AO T R AH M
BEACH	B IY CH
BEAMBUCKLER	B IY M B AH K AH L ER
BEAR	B EH R
BEAR-EVIL	B EH R IY V AH L
BEARD	B IH R D
BEARD-EVIL	B IH R D IY V AH L
BEAST	B IY S T
BEASTS	B IY S T S
BEFUDDLE	B IH F AH D AH L
BEGONE	B IH G AO N
BELLATORAN	B IH L AE T AH R AH N
BELLIGERENT	B AH L IH JH ER AH N T
BELLOWING	B EH L OW IH NG
BENEVOLENT	B AH N EH V AH L AH N T
BERINON	B IY ER IH N AO N
BERSERKER	B IH R S AH R K AH R
BESTIARII	B IH S T AY AH R IY
BEVOR	B IY V AH R
BEVOR-EVIL	B IY V AH R IY V AH L
BEWARE	B IH W EH R
BIBLIOPHILE	B IH B L IY AH F AY L
BIG	B IH G
BIGTWIG	B IH G T W IH G
BILGEWARDEN	B IH L JH W ER D AH N
BILGUM	B AY L G AH M
BIN	B IH N
BINARY	B AY N AH R IY
BINATE	B IH N AH T
BINDING	B AY N D IH NG
BINGLE	B IH NG G AH L
BIOMATRIX	B AY AH M AE T R AH K S
BIOME	B AY OW M
BIRDS	B ER D Z
BLACKSMITH	B L AE K S M IH TH
BLADE	B L EY D
BLAST	B L AE S T
BLASTER	B L AE S T ER
BLATANT	B L EY T AH N T
BLESSING	B L EH S IH NG
BLINDING	B L AY N D IH NG
BLOOD	B L AH D
BLOODSHADOW	B L AH D SH AE D OW
BLOODSHARD	B L AH D SH AA R D
BLOOM	B L UW M
BLORB	B L AO R B
BLOSSOM	B L AA S AH M
BLOW	B L OW
BLYPYP	B L IH P AH P
BO	B OW
BODIES	B AA D IY Z
BOIL	B OY L
BOLD	B OW L D
BOLSTERING	B OW L S T ER IH NG
BOLT	B OW L T
BOLTER	B OW L T ER
BOLTON	B OW L T AH N
BOMB	B AA M
BOMB(2)	B AO M
BOMBARDMENT	B AA M B AA R D M AH N T
BOMBYX	B AA M B AH K S
BONEROT	B OW N R AA T
BONESAW	B OW N S AO
BOOBY	B UW B IY
BOOK	B UH K
BOOKTON	B UH K T AH N
BOOMY	B UW M IY
BOOSTER	B UW S T ER
BOOTS	B UW T S
BORDAN	B AO R D AH N
BOREN	B AO R AH N
BORKA	B AO R K AH
BORR	B AO R
BORROW	B AA R OW
BOSS	B AA S
BOSS(2)	B AO S
BOT	B AA T
BOUNCING	B AW N S IH NG
BOUNTY	B AW N T IY
BOX	B AA K S
BRABBLE	B R AE B AH L
BRACCHANALIA	B R AE K AH N EY L Y AH
BRACCHUS	B R AE K AH S
BRACHIADITUS	B R AH CH IY AE D AH T AH S
BRACKISH	B R AE K IH SH
BRAIN	B R EY N
BRAINDART	B R EY N D AA R T
BRAMBLE	B R AE M B AH L
BRAMMO	B R AE M OW
BRAWL	B R AO L
BREAK	B R EY K
BREAKER	B R EY K ER
BREATH	B R EH TH
BREND	B R EH N D
BREW	B R UW
BRIAR	B R AY ER
BRIKK	B R IH K
BRING	B R IH NG
BROBNAR	B R AA B N AH R
BROKEN	B R OW K AH N
BRONZE	B R AA N Z
BROTHERHOOD	B R AH DH ER HH UH D
BROTHERS	B R AH DH ER Z
BRUNO	B R UW N OW
BRUTODON	B R UW T AH D AH N
BRYOZOARCH	B R AY AH Z OW R K
BUBBLES	B AH B AH L Z
BUG	B AH G
BUGGY	B AH G IY
BULL	B UH L
BULLETEYE	B UH L AH T AY
BULLETS	B UH L AH T S
BULWARK	B UH L W ER K
BUMBLEBIRD	B AH M B AH L B ER D
BUMPSY	B AH M P S IY
BUREAUCRAT	B Y UH R AH K R AE T
BUREAUCRAT(2)	B Y UH R OW K R AE T
BURN	B ER N
BURNING	B ER N IH NG
BURY	B EH R IY
BUYOUT	B AY AW T
BUZZLE	B AH Z AH L
BY	B AY
CADET	K AH D EH T
CALL	K AO L
CALLBACK	K AO L B AE K
CALLIPYGIAN	K AE L IH P AH JH AH N
CALV	K AE L V
CAMARADERIE	K AA M ER AA D ER IY
CAMOUFLAGE	K AE M AH F L AA ZH
CAMP	K AE M P
CAN	K AE N
CAN(2)	K AH N
CANDLE	K AE N D AH L
CANNON	K AE N AH N
CAPER	K EY P ER
CAPTAIN	K AE P T AH N
CAPTURA	K AE P T Y AH R AH
CARD	K AA R D
CARGO	K AA R G OW
CARLO	K AA R L OW
CARPE	K AA R P
CARPET	K AA R P AH T
CATCH	K AE CH
CAULDRON	K AA L D R AH N
CAULDRON(2)	K AO L D R AH N
CAUSAL	K AO Z AH L
CAVE	K EY V
CAVERN	K AE V ER N
CEASEFORGE	S IY S F OW R JH
CELESTIAL	S AH L EH S CH AH L
CEMENT	S AH M EH N T
CEMENT(2)	S IH M EH N T
CENSOR	S EH N S ER
CENSUS	S EH N S AH S
CENTURION	S EH N T UH R IY AH N
CEPHALOIST	S AH F AE L OW AH S T
CH	S IY
CHAIN	CH EY N
CHAINED	CH EY N D
CHALLE	CH AO L
CHALLENGE	CH AE L AH N JH
CHAMBER	CH EY M B ER
CHAMPION	CH AE M P IY AH N
CHAMPIONS	CH AE M P IY AH N Z
CHAN	CH AE N
CHANCELLOR	CH AE N S AH L ER
CHANCELLOR(2)	CH AE N S L ER
CHANS	CH AE N Z
CHANT	CH AE N T
CHAOS	K EY AA S
CHAOSODON	CH EY AA S AH D AH N
CHAPMAN	CH AE P M AH N
CHAPMAN-EVIL	CH AE P M AH N IY V AH L
CHARETTE	SH ER EH T
CHARGE	CH AA R JH
CHARYBDIS	CH AH R IH B D AH S
CHELONIA	CH AH L OW N Y AH
CHELONIA-EVIL	CH AH L OW N Y AH IY V AH L
CHENILLE	CH EH N AH L
CHEST	CH EH S T
CHIEF	CH IY F
CHIEFTAIN	CH IY F T AH N
CHIEFTAINS	CH IY F T AH N Z
CHIP	CH IH P
CHONKERS	CH AO NG K AH R Z
CHOSEN	CH OW Z AH N
CHOTA	CH OW T AH
CHRONICLES	K R AA N IH K AH L Z
CHRONOPHAGE	K R AA N AH F AH JH
CHRONUS	K R OW N AH S
CHUFF	CH AH F
CINCINNATUS	S IH N S AH N EY T AH S
CIRCUMSPECT	S ER K AH M S P EH K T
CIRCUMSPECT-EVIL	S ER K AH M S P EH K T IY V AH L
CITIZEN	S IH T AH Z AH N
CITIZEN(2)	S IH T IH Z AH N
CITY	S IH T IY
CLAIM	K L EY M
CLARIEL	K L AH R IY L
CLARIEL-EVIL	K L AH R IY L IY V AH L
CLASH	K L AE SH
CLAWDE	K L AO D
CLEANSING	K L EH N Z IH NG
CLEAR	K L IH R
CLERIC	K L EH R IH K
CLOAK	K L OW K
CLOAKING	K L OW K IH NG
CLONE	K L OW N
CLOSED	K L OW Z D
CLOUDS	K L AW D Z
CLUB	K L AH B
CLUMSY	K L AH M Z IY
CODE	K OW D
COIL	K OY L
COINS	K OY N Z
COLD	K OW L D
COLLAR	K AA L ER
COLLECTING	K AH L EH K T IH NG
COLLECTION	K AH L EH K SH AH N
COLLECTOR	K AH L EH K T ER
COLLISION	K AH L IH ZH AH N
COLONEL	K ER N AH L
COLONIST	K AA L AH N IH S T
COLOSSEUM	K AA L AH S IY AH M
COM	K AA M
COMBAT	K AA M B AE T
COMBAT(2)	K AH M B AE T
COME	K AH M
COMING	K AH M IH NG
COMMAND	K AH M AE N D
COMMANDEER	K AA M AH N D IH R
COMMANDER	K AH M AE N D ER
COMMON	K AA M AH N
COMMPOD	K AA M P AA D
COMMUNE	K AA M Y UW N
COMMUNE(2)	K AH M Y UW N
COMPILER	K AH M P AY L ER
CONDUCTION	K AH N D AH K SH AH N
CONDUCTOR	K AH N D AH K T ER
CONJECTURE	K AH N JH EH K CH ER
CONJECTURE(2)	K AH N JH EH K SH ER
CONSCRIPTION	K AH N S K R IH P SH AH N
CONSUL	K AA N S AH L
CONTAINMENT	K AH N T EY N M AH N T
CONTROL	K AH N T R OW L
COOPERATIVE	K OW AA P ER EY T IH V
COPY	K AA P IY
CORE	K AO R
CORNER	K AO R N ER
CORNICEN	K AO R N IH K S JH AH N
CORPULENT	K AO R P Y AH L AH N T
CORRODE	K ER OW D
CORRUPTION	K ER AH P SH AH N
COST	K AA S T
COST(2)	K AO S T
COSTS	K AA S T S
COSTS(2)	K AO S T S
COUNCIL	K AW N S AH L
COVETOUS	K AH V AH T AH S
COWARDS	K AW ER D Z
COWFYNE	K OW W F AY N
COWFYNES	K OW W F AY N Z
CPO	K P OW
CR	S IY R
CRAB	K R AE B
CRAFT	K R AE F T
CRAG	K R AE G
CRASH	K R AE SH
CRASSOSAURUS	K R AE S AH S EY Y AH R AH S
CRAWLER	K R AO L ER
CRAZY	K R EY Z IY
CREED	K R IY D
CREEPER	K R IY P ER
CREEPING	K R IY P IH NG
CREWMAN	K R UW M AH N
CRIM	K R IH M
CRISPUS	K R IH S AH S
CROCAG	K R AA K AH G
CROGG	K R AA G
CROSS	K R AO S
CRUSHING	K R AH SH IH NG
CRYSTAL	K R IH S T AH L
CULF	K AH L F
CULL	K AH L
CULTIST	K AH L T AH S T
CULTIST(2)	K AH L T IH S T
CULTURAL	K AH L CH ER AH L
CUNNING	K AH N IH NG
CUP	K AH P
CURATOR	K Y UH R EY T ER
CURATOR(2)	K Y UH R AH T ER
CURIA	K Y UH R IY AH
CURIOSITY	K Y UH R IY AA S AH T IY
CURRENCY	K ER AH N S IY
CURSE	K ER S
CURSED	K ER S T
CUSTOM	K AH S T AH M
CUSTOMS	K AH S T AH M Z
CUTPURSE	K AH T P ER S
CUTTHROAT	K AH T TH R OW T
CXO	K S OW
CYBER	S AY B ER
CYBERGIANT	S AH B AH R JH AY AH N T
CYCLE	S AY K AH L
D1	D IY W AH N
DAGGER	D AE G ER
DAMMED	D AE M D
DAMNED	D AE M D
DAMO	D AE M OW
DANCE	D AE N S
DARK	D AA R K
DARKNESS	D AA R K N AH S
DARTS	D AA R T S
DATA	D EY T AH
DATA(2)	D AE T AH
DAUGHTER	D AO T ER
DAWN	D AO N
DAWN-EVIL	D AO N IY V AH L
DAY	D EY
DEAD	D EH D
DEALER	D IY L ER
DEATH	D EH TH
DEATHQUARK	D IY AE TH W AH R K
DECADENCE	D EH K AH D AH N S
DECIMUS	D AH S AY M AH S
DEEP	D IY P
DEEPWATER	D IY P W AO T ER
DEEPWOOD	D IY P W UH D
DEFENDER	D IH F EH N D ER
DEFENSE	D IH F EH N S
DEIPNO	D IY IH P N OW
DELIVERY	D IH L IH V ER IY
DEMON	D IY M AH N
DEMONS	D IY M AH N Z
DEN	D EH N
DENDRIX	D IH N D R IH K S
DENIED	D IH N AY D
DERRIC	D EH R AH K
DESIRE	D IH Z AY ER
DESTROY	D IH S T R OY
DESTRUCTIVE	D IH S T R AH K T IH V
DETENTION	D IH T EH N SH AH N
DEUSILLUS	D IY Y AH S IH L AH S
DEVICE	D IH V AY S
DEW	D UW
DEXTERUS	D IH Z T IY R AH S
DEXTRE	D IH Z T AH R
DEXUS	D EH K S AH S
DHARNA	D HH AA R N AH
DHRXGAR	D HH R K S G AA R
DIAMETRIC	D AY AH M EH T R IH K
DICE	D AY S
DIDNT	D IH D N T
DIMENSION	D IH M EH N SH AH N
DINO	D IY N OW
DINOSAUR	D AY N AH S AO R
DINOSAURS	D AY N AH S AO R Z
DIPLO	D IH P L OW
DIPLOMAT	D IH P L AH M AE T
DIRECTOR	D ER EH K T ER
DIRECTOR(2)	D AY R EH K T ER
DIRECTOR(3)	D IY R EH K T ER
DIRECTOR(4)	D IH R EH K T ER
DIS	D IH S
DISCIPLE	D IH S AY P AH L
DISCOMBOBULATOR	D IH S AH M B AA B Y AH L EY T AH R
DISCORD	D IH S K AO R D
DISCOVERY	D IH S K AH V ER IY
DISCOVERY(2)	D IH S K AH V R IY
DISGUISE	D IH S G AY Z
DISINTEGRATOR	D IH S IH N T AH G R AH T ER
DISRUPTION	D IH S R AH P SH AH N
DISTRACTION	D IH S T R AE K SH AH N
DIVE	D AY V
DOC	D AA K
DOCTOR	D AA K T ER
DOCTOR(2)	D AO K T ER
DODGER	D AA JH ER
DOLL	D AA L
DOMINANCE	D AA M AH N AH N S
DOMINATOR	D AA M AH N AH T ER
DONATIONS	D OW N EY SH AH N Z
DONGLE	D AA N G AH L
DOOM	D UW M
DOOR	D AO R
DOORSTEP	D AO R S T EH P
DORY	D AO R IY
DOUBLE	D AH B AH L
DOWN	D AW N
DR	D R AY V
DR(2)	D AA K T ER
DRACO	D R EY K OW
DRACO(2)	D R AE K OW
DRAGNET	D R AE G N EH T
DRAGON	D R AE G AH N
DRAIN	D R EY N
DRAINING	D R EY N IH NG
DRAKE	D R EY K
DRAWN	D R AO N
DREADBONE	D R EH D B OW N
DREAMS	D R IY M Z
DRECKER	D R EH K AH R
DREDGING	D R EH JH IH NG
DRIFT	D R IH F T
DRISCOLL	D R IH S K AH L
DRIVE	D R AY V
DROID	D R OY D
DRUID	D R UW IH D
DRUMBLE	D R AH M B AH L
DRUMMERNAUT	D R AH M AH R N AH T
DRUSILLA	D R UW S IH L AH
DRY	D R AY
DTHOSHRA	D TH AA SH R AH
DUMA	D UW M AH
DUSK	D AH S K
DUSKRUNNER	D AH S K R AH N ER
DUSKWITCH	D AH S K W IH CH
DUST	D AH S T
DUX	D AH K S
DYNAMO	D AY N AH M OW
DYSANIA	D AH S EY N Y AH
EARLY	ER L IY
EARTHBIND	ER TH B AY N D
EARTHSHAKER	ER TH SH EY K ER
EASY	IY Z IY
EATER	IY T ER
ECHO	EH K OW
ECLECTIC	IH K L EH K T IH K
ECLIPSE	IH K L IH P S
ECLIPSE(2)	AH K L IH P S
ECLIPSE(3)	IY K L IH P S
ECONOMIST	IH K AA N AH M IH S T
ECONOMIST(2)	IY K AA N AH M IH S T
EDAI	EH D EY
EDICT	IY D IH K T
EDIE	EH D IY
EE	IY
EFFERVESCENT	EH F ER V EH S AH N T
EFFIGY	EH F IH JH IY
EGAD	EH G AH D
EGAD-EVIL	EH G AH D IY V AH L
EGG	EH G
EKWIRRE	EH K W AH R
EL	EH L
ELDER	EH L D ER
ELDEST	EH L D AH S T
ELECTION	IH L EH K SH AH N
EMBER	EH M B ER
EMERITUS	IH M EH R AH T AH S
EMISSION	IH M IH SH AH N
EMITTER	IH M IH T ER
EMP	EH M P
ENCODER	EH N K OW D ER
ENCOUNTER	IH N K AW N T ER
ENCOUNTER(2)	IH N K AW N ER
END	EH N D
ENDLESS	EH N D L AH S
ENFORCER	EH N F AO R S ER
ENFORCER-EVIL	EH N F AO R S ER IY V AH L
ENGINEER	EH N JH AH N IH R
ENLIGHTENMENT	EH N L AY T AH N M AH N T
ENLIST	EH N L IH S T
ENSIGN	EH N S AH N
ENTANGLER	EH N T AE NG G AH L ER
ENTROPIC	EH N T R AA P IH K
ENVOY	EH N V OY
ENVOY(2)	AA N V OY
ENVY	EH N V IY
EPIC	EH P IH K
EQUALIZE	IY K W AH L AY Z
EQUILIBRIUM	IY K W AH L IH B R IY AH M
ESCOTERA	EH S AA T AH R AH
ESPION	EH S IY AH N
ESPION-EVIL	EH S IY AH N IY V AH L
ESQUIRE	EH S K W AY R
ESSENCE	EH S AH N S
ETANS	EH T AH N Z
ETAROMME	EH T AH R AH M
ETHER	IY TH ER
EUNOIA	Y UW N OY AH
EUREKA	Y UH R IY K AH
EVASION	IH V EY ZH AH N
EVASION(2)	IY V EY ZH AH N
EVEN	IY V IH N
EVERLASTING	EH V ER L AE S T IH NG
EVERYWHERE	EH V R IY W EH R
EVERYWHERE(2)	EH V R IY HH W EH R
EVIL	IY V AH L
EVOLUTION	EH V AH L UW SH AH N
EVOLUTION(2)	IY V AH L UW SH AH N
EVOLUTION(3)	EH V OW L UW SH AH N
EVOLUTION(4)	IY V OW L UW SH AH N
EWER	Y UW ER
EXCHANGE	IH K S CH EY N JH
EXHUME	EH K S HH Y UW M
EXILE	EH G Z AY L
EXILE(2)	EH K S AY L
EXO	IH G Z OW
EXPERIMENTAL	IH K S P EH R IH M EH N T AH L
EXPERIMENTATION	IH K S P EH R AH M AH N T EY SH AH N
EXPLO	IH K S L OW
EXPLOIT	EH K S P L OY T
EXPLOITER	EH K S P L OY T ER
EXPLORATORY	IH K S P L AO R AH T AO R IY
EXPLORER	IH K S P L AO R ER
EXTERMINATE	IH K S T ER M AH N EY T
EXTINCTION	IH K S T IH NG K SH AH N
EXTINCTION(2)	IH K S T IH NG SH AH N
EXTREMATODE	IH K S T R EH M AH T OW D
EYE	AY
EYED	AY D
EYEGOR	EY AH G AH R
FAERIE	F IY R AY
FAIR	F EH R
FAMINE	F AE M AH N
FANATIC	F AH N AE T IH K
FANDANGLE	F AE N D AE NG G AH L
FANGHOUSE	F AE NG HH AW S
FANGS	F AE NG Z
FANGTOOTH	F AE NG T UW TH
FATES	F EY T S
FATHER	F AA DH ER
FATHOM	F AE DH AH M
FAUST	F AW S T
FAVIAN	F EY V IY AH N
FAVOR	F EY V ER
FAYE	F EY
FAYE-EVIL	F EY IY V AH L
FAYGIN	F EY JH IH N
FEAR	F IH R
FEATHERED	F EH DH ER D
FEATS	F IY T S
FEEDING	F IY D IH NG
FELIX	F IY L IH K S
FELIX-EVIL	F IY L IH K S IY V AH L
FENCE	F EH N S
FERTILITY	F ER T IH L AH T IY
FERTILITY(2)	F ER T IH L IH T IY
FESTERING	F EH S T ER IH NG
FETCHDRONES	F EH CH D R OW N Z
FEW	F Y UW
FIDDLE	F IH D AH L
FIDGIT	F IH JH AH T
FIELD	F IY L D
FIEND	F IY N D
FIERCE	F IH R S
FIFALDE	F IH F AH L D
FIGHT	F AY T
FILA	F AY L AH
FINAL	F AY N AH L
FINCH	F IH N CH
FINGER	F IH NG G ER
FINGERS	F IH NG G ER Z
FINGERTRAP	F IH NG G ER T R AE P
FINISHED	F IH N IH SH T
FINISHING	F IH N IH SH IH NG
FIRE	F AY ER
FIRE(2)	F AY R
FIRESPITTER	F AY ER S P IH T ER
FIRST	F ER S T
FISH	F IH SH
FISHES	F IH SH AH Z
FISHES(2)	F IH SH IH Z
FISSION	F IH SH AH N
FITTEST	F IH T AH S T
FIX	F IH K S
FLAME	F L EY M
FLAMEFIST	F L EY M F IH S T
FLAMEGILL	F L EY M G IH L
FLAMETHROWER	F L EY M TH R OW ER
FLAMEWAKE	F L EY M W EY K
FLAMEWING	F L EY M W IH NG
FLASH	F L AE SH
FLAXIA	F L AE K S IY AH
FLEA	F L IY
FLEET	F L IY T
FLEX	F L EH K S
FLOOMF	F L UW M F
FLOOR	F L AO R
FLOUNDERIGHT	F L AW N D AH R AY T
FLOWERS	F L AW ER Z
FLUTE	F L UW T
FLUX	F L AH K S
FLYIN	F L AY IH N
FOF	F AA F
FOGBANK	F AA G B AE NG K
FOGGIFY	F AA G AH F AY
FOLLOW	F AA L OW
FONT	F AA N T
FOOZLE	F UW Z AH L
FOR	F AO R
FOR(2)	F ER
FOR(3)	F R ER
FORCE	F AO R S
FORCED	F AO R S T
FOREST	F AO R AH S T
FOREST(2)	F AO R IH S T
FORGE	F AO R JH
FORGEMASTER	F OW R JH M AE S T ER
FORGET	F ER G EH T
FORGET(2)	F AO R G EH T
FORGING	F AO R JH IH NG
FORGIVE	F ER G IH V
FORGIVE(2)	F AO R G IH V
FORGOTTEN	F ER G AA T AH N
FORGOTTEN(2)	F AO R G AA T AH N
FORMATION	F AO R M EY SH AH N
FORUM	F AO R AH M
FOUND	F AW N D
FRANCIS	F R AE N S AH S
FRANCIS(2)	F R AE N S IH S
FRANCUS	F R AE NG K AH S
FRANE	F R EY N
FRANES	F R EY N Z
FRAY	F R EY
FREE	F R IY
FREEBOOTER	F R IY B UW T ER
FREELANCER	F R IY L AE N S ER
FREEZE	F R IY Z
FRENZY	F R EH N Z IY
FRESH	F R EH SH
FRIENDLY	F R EH N D L IY
FRIENDSHIP	F R EH N D SH IH P
FRIGORIFIC	F R IH G AH R IH F AH K
FRINGES	F R IH N JH IH Z
FROM	F R AH M
FRONTIERS	F R AH N T IH R Z
FROST	F R AO S T
FUGURU	F Y UW G Y AH R UW
FULL	F UH L
FURTIVE	F ER T IH V
FURY	F Y UH R IY
FUTURE	F Y UW CH ER
FUZZY	F AH Z IY
FYRE	F AY R
GABOON	G AH B UW N
GABOS	G AE B AA S
GALACTIC	G AH L AE K T IH K
GALEATOPS	G EY L AH T AA P S
GALLIM	G AE L AH M
GAMBLING	G AE M B AH L IH NG
GAMBLING(2)	G AE M B L IH NG
GAME	G EY M
GAMGEE	G AE M JH IY IY
GANG	G AE NG
GANGER	G AE NG ER
GANYMEDE	G AE N AH M IY D
GARCIA	G AA R S IY AH
GARCIAS	G AA R S IY AH Z
GARGANTES	G AA R G AH N T S
GARGANTODON	G AA R G AE N T AH D AH N
GARWYNNE	G AA R W AH N
GARWYNNE-EVIL	G AA R W AH N IY V AH L
GAS	G AE S
GATEKEEPER	G EY T K IY P ER
GATES	G EY T S
GATEWAY	G EY T W EY
GAUNTLET	G AO N T L AH T
GAZE	G EY Z
GEBUK	JH EH B AH K
GED	G EH D
GED(2)	JH IY IY D IY
GEL	JH EH L
GEMCOAT	JH EH M K OW T
GENERAL	JH EH N ER AH L
GENERAL(2)	JH EH N R AH L
GENERATOR	JH EH N ER EY T ER
GENEROSITY	JH EH N ER AA S AH T IY
GENEROUS	JH EH N ER AH S
GENETIC	JH AH N EH T IH K
GEZDRUTYO	JH EH Z D R UW T AY OW
GEZRAHI	JH EH Z R AH HH IY
GHOSTFIN	G OW S T F IH N
GHOSTFORM	G OW S T F AO R M
GHOSTHAWK	G OW S T HH AO K
GHOSTLY	G OW S T L IY
GIANT	JH AY AH N T
GIANTS	JH AY AH N T S
GIGANTICA	JH AH G AE N T AH K AH
GILTSPINE	G IH L T S P AY N
GIZELHART	JH AH Z EH L HH AH R T
GIZELHARTS	JH AH Z EH L HH AH R T S
GIZMO	G IH Z M OW
GLADIODONTUS	G L EY D IY AH D AA N T AH S
GLARE	G L EH R
GLEBE	G L IY B
GLEEFUL	G L IY F AH L
GLIMMER	G L IH M ER
GLOOM	G L UW M
GLORIANA	G L AO R IY AE N AH
GLORIANAS	G L AH R IY AH N AH Z
GLORIOUS	G L AO R IY AH S
GLORY	G L AO R IY
GLOW	G L OW
GLOW-EVIL	G L OW IY V AH L
GLUTTONY	G L AH T AH N IY
GLYLYX	G L IH L AH K S
GLYXL	G L IH K S L
GNAWBILL	N AO B IH L
GOBLIN	G AA B L IH N
GOLD	G OW L D
GOLDEN	G OW L D AH N
GOLGOTHA	G OW L G AH TH AH
GONGOOZLE	G AA N G UW Z AH L
GOOD	G UH D
GOOD(2)	G IH D
GORD	G AO R D
GORKUS	G AO R K AH S
GORM	G AO R M
GORVENAL	G AO R V AH N AH L
GRABBER	G R AE B ER
GRAFT	G R AE F T
GRAM	G R AE M
GRAMMARBOT	G R AE M AA R B AH T
GRAMMATICUS	G R AE M AH T IH S AH S
GRAND	G R AE N D
GRANDEUR	G R AE N D UW R
GRASPING	G R AE S P IH NG
GRAVE	G R EY V
GRAVELGUTS	G R AE V AH L G AH T S
GRAVID	G R AE V AH D
GRAVITRON	G R AH V IH T R AH N
GRAY	G R EY
GREAT	G R EY T
GREATER	G R EY T ER
GREED	G R IY D
GREEN	G R IY N
GREKING	G R IY K AH NG
GRENADE	G R AH N EY D
GREY	G R EY
GRIM	G R IH M
GRIMLOCUS	G R IH M L OW K AH S
GRISK	G R IH S
GROGGINS	G R AA G JH IH N Z
GROKE	G R OW K
GROKES	G R OW K S
GROMMID	G R AA M AH D
GRON	G R AA N
GRONDAL	G R AA N D AH L
GRONS	G R AA N Z
GROSS	G R OW S
GROUNDBREAKING	G R AW N D B R EY K IH NG
GROUNDBREAKING(2)	G R AW N B R EY K IH NG
GROUNDS	G R AW N D Z
GROUNDS(2)	G R AW N Z
GROUPTHINK	G R UW P TH IH NG K
GROVEKEEPER	G R OW V K IY P ER
GROWTH	G R OW TH
GRUBBLING	G R AH B L AH NG
GRUEN	G R UW N
GRUMP	G R AH M P
GRUMPUS	G R AH M P AH S
GRUNT	G R AH N T
GUARD	G AA R D
GUARDIAN	G AA R D IY AH N
GUB	G AH B
GUIDE	G AY D
GUILTY	G IH L T IY
GUJI	G Y UW JH IY
GUN	G AH N
GUTHRAK	G AH TH R AH K
HACK	HH AE K
HADRON	HH AE D R AO N
HAEDROTHS	HH IY D R AH TH S
HALACOR	HH AE L AH S AH R
HALLAFEST	HH AE L EY F AH S T
HALLOWED	HH AE L OW D
HALO	HH EY L OW
HAMMER	HH AE M ER
HAND	HH AE N D
HANDS	HH AE N D Z
HANDS(2)	HH AE N Z
HAPLESS	HH AE P L AH S
HAPSIS	HH AE P S IY Z
HARBINGER	HH AA R B IH N JH ER
HARD	HH AA R D
HARDER	HH AA R D ER
HARLAND	HH AA R L AH N D
HARM	HH AA R M
HARMAL	HH AA R M AH L
HARMONIA	HH AA R M OW N IY AH
HARMONIC	HH AA R M AA N IH K
HARUSPEX	HH AH R AH S AH K S
HARVEST	HH AA R V AH S T
HARVESTER	HH AA R V AH S T ER
HASTATUS	HH AE S T EY T AH S
HATE	HH EY T
HAWKINS	HH AO K IH N Z
HAWKINS-EVIL	HH AO K IH N Z IY V AH L
HAYDEN	HH EY D AH N
HAYYEL	HH EY AY AH L
HAZRI	HH AE Z R IY
HEADHUNTER	HH EH D HH AH N T ER
HEAL	HH IY L
HEALING	HH IY L IH NG
HEART	HH AA R T
HEARTS	HH AA R T S
HEAVEN	HH EH V AH N
HEAVY	HH EH V IY
HEBE	HH IY B
HECATOMB	HH EH K AH T OW M
HEDONISTIC	HH IY D AH N IH S T IH K
HEIST	HH AY S T
HELMSMAN	HH EH L M Z M AE N
HELP	HH EH L P
HELPER	HH EH L P ER
HEMA	HH EH M AH
HERD	HH ER D
HERDER	HH EH R D ER
HERDER(2)	HH ER D ER
HERO	HH IH R OW
HERO(2)	HH IY R OW
HEXPION	HH EH K S IY AH N
HIDDEN	HH IH D AH N
HIDEAWAY	HH AY D AH W EY
HIGH	HH AY
HILL	HH IH L
HINGS	HH IY IH NG Z
HIRE	HH AY ER
HIRE(2)	HH AY R
HISSARO	HH IH S AH R OW
HISTORY	HH IH S T ER IY
HISTORY(2)	HH IH S T R IY
HIT	HH IH T
HIVE	HH AY V
HOBNOBBER	HH AA B N AA B ER
HOBNOBBER-EVIL	HH AA B N AA B ER IY V AH L
HOCK	HH AA K
HOLD	HH OW L D
HOLDFAST	HH OW L F AE S T
HOLE	HH OW L
HOLOGRAMMOPHONE	HH AH L AH G R AE M AH F OW N
HOME	HH OW M
HONOR	AA N ER
HONORABLE	AA N ER AH B AH L
HONORS	AA N ER Z
HOOKMASTER	HH UH K M AE S T ER
HOOLIGANS	HH UW L IH G AH N Z
HOPE	HH OW P
HOPLITES	HH AA P L AY T S
HORDES	HH AO R D Z
HORN	HH AO R N
HORNS	HH AO R N Z
HORNSWOGGLE	HH AO R N S W AH G AH L
HORRID	HH AO R AH D
HORSEMAN	HH AO R S M AH N
HOSTAGES	HH AA S T AH JH AH Z
HOT	HH AA T
HOUNDS	HH AW N D Z
HOUSE	HH AW S
HOWLING	HH AW L IH NG
HUBRIS	HH Y UW B R AH S
HUGE	HH Y UW JH
HUGE(2)	Y UW JH
HUGGER	HH AH G ER
HUMAN	HH Y UW M AH N
HUMAN(2)	Y UW M AH N
HUMANS	HH Y UW M AH N Z
HUMANS(2)	Y UW M AH N Z
HUMBLE	HH AH M B AH L
HUNT	HH AH N T
HUNTED?	HH AH N T IH D
HUNTER	HH AH N T ER
HUNTING	HH AH N T IH NG
HURLING	HH ER L IH NG
HYDE	HH AY D
HYDROCATALOGUER	HH IH D R AH K AH T AE L AH G AH R
HYMN	HH IH M
HYPNOBEAM	HH IH P N AH B IY M
HYPNOTIC	HH IH P N AA T IH K
HYPOXIA	HH AY P AA K S IY AH
HYSTERIA	HH IH S T EH R IY AH
HYSTRICOG	HH IH S T R AH K AH G
I	AY
ID	IH D
ID(2)	AY D IY
IDEAL	AY D IY L
IDES	AY D Z
IGON	AY G AH N
IKWIJI	IH K W AH JH IY
ILLUMINATOR	IH L UW M AH N EY T ER
IMP	IH M P
IMPERATOR	IH M P ER EY T ER
IMPERIAL	IH M P IH R IY AH L
IMPERIUM	IH M P AH R IY AH M
IMPRINTED	IH M P R IH N T IH D
IMPRINTED(2)	IH M P R IH N IH D
IMPSPECTOR	IH M S EH K T AH R
IN	IH N
INCONSPICUOUS	IH NG K AA N S P IH K W AH S
INCUBATION	IH NG K Y UW B EY SH AH N
INDOMINUS	IH N D UW M AY N AH S
INFECTION	IH N F EH K SH AH N
INFIGHTING	IH N F AY T IH NG
INFOMANCER	IH N F AH M AE N S AH R
INFOMORPH	IH N F AA M AH R F
INFORMATION	IH N F AO R M EY SH AH N
INFURNACE	IH N F ER N AH S
INGRAM	IH NG G R AH M
INGRAMS	IH N G R AE M Z
INITIATION	IH N IH SH IY EY SH AH N
INITIATIVE	IH N IH SH AH T IH V
INITIATIVE(2)	IH N IH SH Y AH T IH V
INKA	IH N K AA
INKY	IH NG K IY
INQUIRY	IH N K W AY R IY
INQUIRY(2)	IH N K W AH R IY
INSIGNIFICANCE	IH N S IH G N Y IH F IH K AH N S
INSPIRATION	IH N S P ER EY SH AH N
INSPIRING	IH N S P AY R IH NG
INSPIRING(2)	IH N S P AY ER IH NG
INSTINCT	IH N S T IH NG K T
INSTRUMENT	IH N S T R AH M AH N T
INSURANCE	IH N SH UH R AH N S
INTENT	IH N T EH N T
INTERDIMENSIONAL	IH N T ER D AH M EH N CH AH N AH L
INTEREST	IH N T AH R EH S T
INTO	IH N T UW
INTO(2)	IH N T AH
INVADERS	IH N V EY D ER Z
INVASION	IH N V EY ZH AH N
INVESTOR	IH N V EH S T ER
INVESTORS	IH N V EH S T ER Z
INVIDIUS	IH N V IH D AY AH S
INVISIBILITY	IH N V IH Z AH B IH L AH T IY
INVULNERABILITY	IH N V AH L N ER AH B IH L IH T IY
IRESTAFF	AY ER S T AE F
IRON	AY ER N
IRONS	AY ER N Z
IRONYX	IH R AH N AH K S
IRRADIATED	IH R EY D IY EY T IH D
IS	IH Z
ISOTROPIC	AY S AH T R AA P IH K
ISS	IH Z
IT	IH T
ITS	IH T S
IVAN	AY V AH N
IXXYXLI	IH K S IH K S L IY
J	JH EY
JACKIE	JH AE K IY
JAGA	JH AE G AH
JAMMER	JH AE M ER
JAR	JH AA R
JARGOGLE	JH AA R G AH G AH L
JARK	JH AA R K
JARL	JH AA R L
JARROYA	JH AE R OY AH
JARTA	JH AA R T AH
JAVELIN	JH AE V AH L AH N
JAVELIN(2)	JH AE V AH L IH N
JAVELIN(3)	JH AE V L AH N
JAVELIN(4)	JH AE V L IH N
JEHU	JH EH HH UW
JERICHO	JH EH R IH K OW
JOB	JH AA B
JOB(2)	JH OW B
JOHN	JH AA N
JOHNNY	JH AA N IY
JON	JH AA N
JOURNEY	JH ER N IY
JOYA	JH OY AH
JUDGMENT	JH AH JH M AH N T
JUSTICE	JH AH S T AH S
JUSTICE(2)	JH AH S T IH S
JöRG	JH EY AA R G
KABOOM	K AH B UW M
KALOCH	K AE L AH CH
KAMALANI	K AH M AE L AH N IY
KANGAPHANT	K AE N G AH F AH N T
KARTANOO	K AA R T AH N UW
KASSIEL	K AE S IY L
KATERINA	K AH T EH R AH N AH
KAUPE	K AO P
KAUPE-EVIL	K AO P IY V AH L
KEKOA	K EH K OW AH
KELIFI	K EH L AH F IY
KELPING	K EH L P IH NG
KELPMINDER	K EH L P M AY N D ER
KERING	K IY R AH NG
KERWOLLOP	K AH R W AA L AH P
KEY	K IY
KEYFORGERY	K IY F OW R JH AH R IY
KEYFROG	K IY F R AA G
KEYLOCK	K IY L AA K
KEYSIS	K IY Z IY Z
KHRKHAR	K HH R K AA R
KHRKHARS	K HH R K AA R Z
KILIGOG	K IH L AH G AH G
KILIGOGS	K IH L AH G AH G Z
KILLING	K IH L IH NG
KILLZORD	K IH L Z AH R D
KIN	K IH N
KINDRITH	K AY N D R IY TH
KING	K IH NG
KIRBY	K ER B IY
KIRBYS	K AH R B AH Z
KIRI	K IH R IY
KNIFE	N AY F
KNIGHT	N AY T
KNIGHTAPULT	N AY T AH P AH L T
KNOWDRONE	N OW D R OW N
KNOWLEDGE	N AA L AH JH
KNOWLEDGE(2)	N AA L IH JH
KNOXX	N AA K S
KNUCKLES	N AH K AH L Z
KOMPSOS	K AA M P S AH Z
KONG	K AO NG
KONG(2)	K AO NG G
KORIJIR	K AO R AH JH AH R
KRAKEN	K R EY K AH N
KRESAGE	K R IY Z AH JH
KRESAGE-EVIL	K R IY Z AH JH IY V AH L
KRETCHEE	K R AH CH IY IY
KRRRZZZAAAP	K R Z AA AH P
KRUMP	K R AH M P
KYMOOR	K IH M OW AH R
LABORATORY	L AE B R AH T AO R IY
LABWORK	L AE B W ER K
LACUS	L EY K AH S
LADY	L EY D IY
LAKE	L EY K
LAKE-EVIL	L EY K IY V AH L
LAMINDRA	L AH M IH N D R AH
LANCE	L AE N S
LAND	L AE N D
LANDER	L AE N D ER
LANDING	L AE N D IH NG
LANDS	L AE N D Z
LANG	L AE NG
LAPISAURUS	L AE P AH S EY Y AH R AH S
LAPISAURUS-EVIL	L AE P AH S EY Y AH R AH S IY V AH L
LARIE	L AE R AY
LASH	L AE SH
LAST	L AE S T
LATER	L EY T ER
LATER-EVIL	L EY T ER IY V AH L
LATERAL	L AE T ER AH L
LAVA	L AA V AH
LAY	L EY
LCDR	EH L S IY D IY R
LEADER	L IY D ER
LECTOR	L EH K T ER
LEGATUS	L IY G EY T AH S
LEGIONARY	L IY JH AH N EH R IY
LEGIONS	L IY JH AH N Z
LEQ	L EH K
LESSER	L EH S ER
LETHAL	L IY TH AH L
LETHOLOGICA	L EH TH AH L AA JH AH K AH
LIAM	L IY AH M
LIBRARIAN	L AY B R EH R IY AH N
LIBRARY	L AY B R EH R IY
LIEUTENANT	L UW T EH N AH N T
LIFE	L AY F
LIFEWARD	L AY F W ER D
LIFEWEB	L AY F W EH B
LIGHT	L AY T
LIGHTBRINGER	L AY T B R IH NG ER
LIGHTS	L AY T S
LIGHTSMITH	L AY T S M IH TH
LILITHAL	L IH L IY TH AH L
LINE	L AY N
LINK	L IH NG K
LION	L AY AH N
LITTLE	L IH T AH L
LIU	L Y UW
LIVIA	L IH V IY AH
LLACK	L AE K
LOGOS	L OW G OW Z
LOLLOP	L AA L AH P
LOMIR	L AA M AH R
LONE	L OW N
LONGARMS	L AO NG AA R M Z
LONGFINGERS	L AO NG F IH NG G ER Z
LONGFUSED	L AO NG F Y UW Z D
LONGSHOT	L AO NG SH AA T
LONGUSAUR	L AA N G Y UW S AH R
LOOK	L UH K
LOOP	L UW P
LOOT	L UW T
LOOTER	L UW T ER
LORD	L AO R D
LOREENA	L AH R IY N AH
LOSION	L UW ZH AH N
LOST	L AO S T
LOTTERY	L AA T ER IY
LOW	L OW
LUCKY	L AH K IY
LUDO	L UW D OW
LUMILU	L UW M AH L UW
LUPO	L UW P OW
LYCO	L IH K OW
LYNX	L IH NG K S
MAB	M AE B
MACHINE	M AH SH IY N
MACIS	M EY S AH S
MACK	M AE K
MACY	M EY S IY
MAD	M AE D
MAGDA	M AE G D AH
MAGISTRA	M AH JH IH S T R AH
MAGISTRATE	M AE JH AH S T R EY T
MAGISTRATE(2)	M AE JH IH S T R EY T
MAGNET	M AE G N AH T
MAKE	M EY K
MAKER	M EY K ER
MAKES	M EY K S
MALEFACTION	M EY L F AE K SH AH N
MALEFICORN	M AH L EH F AH K AH R N
MALISON	M EY L IY Z AO N
MALKIN	M AE L K IH N
MALONE	M AH L OW N
MALSTROM	M AE L S T R AH M
MAMA	M AA M AH
MAN	M AE N
MANCHEGO	M AE NG K AH G OW
MANEUVER	M AH N UW V ER
MANIPULATOR	M AH N IH P Y AH L EY T ER
MANS	M AE N Z
MANTLE	M AE N T AH L
MANY	M EH N IY
MAP	M AE P
MARAUDER	M ER AO D ER
MARCH	M AA R CH
MARIANA	M AA R IY AE N AH
MARIUS	M AA R IY AH S
MARK	M AA R K
MARKED	M AA R K T
MARKET	M AA R K AH T
MARKET(2)	M AA R K IH T
MARKETS	M AA R K AH T S
MARKETS(2)	M AA R K IH T S
MARKS	M AA R K S
MARMO	M AA R M OW
MARROWS	M AE R OW Z
MARS	M AA R Z
MARSHAL	M AA R SH AH L
MARTIAN	M AA R SH AH N
MARTIANOLOGIST	M AA R T IY AH N AA L AH JH AH S T
MARTIANS	M AA R SH AH N Z
MARTYR	M AA R T ER
MARTYRS	M AA R T ER Z
MARUCK	M AE R AH K
MASS	M AE S
MASTER	M AE S T ER
MASTERMINDY	M AE S T ER M AY N D IY
MASTERPLAN	M AE S T ER P L AE N
MASTERY	M AE S T ER IY
MATING	M EY T IH NG
MATTER	M AE T ER
MAUL	M AO L
MAX	M AE K S
MAXENA	M AE K S AH N AH
MAYHEM	M EY HH EH M
MECHABUOY	M AH CH AE B Y UW OW IY
MECHANIC	M AH K AE N IH K
MECHANIC(2)	M IH K AE N IH K
MECHS	M EH CH S
MEDIC	M EH D IH K
MEDICUS	M EH D IH K AH S
MEGA	M EH G AH
MEGAMOUTH	M EH G AH M AW TH
MELEE	M EY L EY
MELERUKH	M EH L AH R AH K
MEMBERSHIP	M EH M B ER SH IH P
MEMOLITH	M EH M OW L IY TH
MEMORY	M EH M ER IY
MEMROX	M EH M R AH K S
MENGEVIN	M EH N JH AH V AH N
MERCHANT	M ER CH AH N T
MERCY	M ER S IY
MESMERIST	M IY Z M IH ER IH S T
METEOR	M IY T IY ER
MIASMA	M IY AE Z M AH
MIASMA(2)	M AY AE Z M AH
MIGHT	M AY T
MIGHTY	M AY T IY
MILLI	M IH L IY
MIMIC	M IH M IH K
MIMICRY	M IH M IH K R IY
MIND	M AY N D
MINDFIRE	M AY N D F AY ER
MINDLOCK	M AY N D L AA K
MINDWARPER	M AY N D W AO R P ER
MINDWORM	M AY N D W ER M
MINES	M AY N Z
MINI	M IH N IY
MINION	M IH N Y AH N
MIRROR	M IH R ER
MISERY	M IH Z ER IY
MISSION	M IH SH AH N
MK	EH M K
MK2	EH M K EY T UW
MOB	M AA B
MOBIUS	M OW B IY AH S
MODE	M OW D
MOGGHUNTER	M AH G AH N T AH R
MOGGHUNTERS	M AH G AH N T AH R Z
MOLE	M OW L
MOLEPHIN	M AA L AH F AH N
MOLINA	M AH L IY N AH
MOLINAS	M AA L AH N AH Z
MOLLUSCALLER	M AA L AH S AO L AH R
MOLLYMAWK	M AA L AH M AH K
MONEY	M AH N IY
MONGREL	M AA N G R AH L
MONK	M AH NG K
MONKEY	M AH NG K IY
MONKEYS	M AH NG K IY Z
MONTY	M AO N T IY
MONUMENT	M AA N Y UW M AH N T
MONUMENT(2)	M AA N Y AH M AH N T
MOOKLING	M UH K L AH NG
MOOKLING-EVIL	M UH K L AH NG IY V AH L
MOON	M UW N
MOONCURSER	M UW N K ER S ER
MOOR	M UH R
MORAY	M ER EY
MORAY(2)	M AO R EY
MORAY-EVIL	M ER EY IY V AH L
MORPHEUS	M AO R F IY AH S
MOTHER	M AH DH ER
MOTHERGUN	M AH DH ER G AH N
MOTHERSHIP	M AH DH ER SH IH P
MOUNT	M AW N T
MUCH	M AH CH
MUG	M AH G
MUGGER	M AH G ER
MUGWUMP	M AH G W AH M P
MULDOON	M AH L D UW N
MUNCHLING	M AH N CH L IH NG
MURKENS	M ER K AH N Z
MURMOOK	M AH R M AH K
MUSHROOM	M AH SH R UW M
MUSTER	M AH S T ER
MUSTHIC	M AH S TH AH K
MUTAGENESIS	M Y UW T AH JH IY N AH S AH S
MUTAGENIC	M Y UW T IH JH AH N IH K
MUTANT	M Y UW T AH N T
MUTATION	M Y UW T EY SH AH N
MYLIOBE	M IH L IY OW B
MYSTICETI	M IH S T IH S AH T IY
MYX	M IH K S
NARP	N AA R P
NARPS	N AA R P S
NASTEE	N AE S T IY IY
NATURE	N EY CH ER
NATURES	N EY CH ER Z
NAUTILIXIAN	N AO T AH L IH K S IY AH N
NAVIGATOR	N AE V AH G EY T ER
NEEDLE	N IY D AH L
NEEDS	N IY D Z
NEFFRU	N EH F R UW
NEGOTIATION	N IH G OW SH IY EY SH AH N
NEL	N EH L
NEPENTHE	N EH P EH N TH IY
NEPETA	N EH P AH T AH
NEROTAURUS	N EH R AH T EY Y AH R AH S
NERVE	N ER V
NETCASTER	N EH T K AE S T ER
NETCASTER-EVIL	N EH T K AE S T ER IY V AH L
NETWORK	N EH T W ER K
NEURO	N UH R OW
NEUTRON	N UW T R AA N
NEW	N UW
NEW(2)	N Y UW
NEXUS	N EH K S AH S
NIFF	N IH F
NIFFLE	N IH F AH L
NIGHT	N AY T
NIGHTFORGE	N AY T F OW R JH
NIGHTMARE	N AY T M EH R
NINE	N AY N
NIRBOR	N AH R B AH R
NIT	N IH T
NITHING	N IH DH AH NG
NITS	N IH T S
NIZAK	N IH Z AH K
NO	N OW
NOCTURNAL	N AA K T ER N AH L
NODDY	N AA D IY
NOGI	N OW JH IY
NONAME	N AH N EY M
NORBYNS	N AO R B AH N Z
NORTHELLE	N AO R TH AH L
NOT	N AA T
NOVU	N OW V UW
NOZZLE	N AA Z AH L
NUMBERS	N AH M B ER Z
NUMERI	N Y UW M AH R IY
NUMQUID	N AH M K W AH D
NURSE	N ER S
NURTURE	N ER CH ER
NYYON	N AY AY AH N
NYZYK	N IH Z AH K
OATH	OW TH
OBELISK	AA B AH L IH S K
OBLIVION	AH B L IH V IY AH N
OBSERV	AA B S AH R V
OBSIDIAN	AH B S IH D IY AH N
OCTAVIA	AA K T EY V IY AH
ODD	AA D
ODOAC	AH D OW K
OF	AH V
OFF	AO F
OFFER	AO F ER
OFFERING	AO F ER IH NG
OFFERING(2)	AO F R IH NG
OFFICE	AO F AH S
OFFICER	AO F AH S ER
OFFICER(2)	AO F IH S ER
OFFICERS	AO F AH S ER Z
OFFICERS(2)	AO F IH S ER Z
OG	AA G
OGOPOGO	AH G AA P AH G OW
OGRE	OW G ER
OL	AA L
OLD	OW L D
OMM	AA M
OMNIPUS	AA M N AH P AH S
ON	AA N
ON(2)	AO N
ONE	W AH N
ONE(2)	HH W AH N
ONYX	AA N IH K S
OPAL	OW P AH L
OPERATION	AA P ER EY SH AH N
OPERATIONS	AA P ER EY SH AH N Z
OPERATIVE	AA P ER AH T IH V
OPPORTUNIST	AA P ER T UW N IH S T
OPPOSITION	AA P AH Z IH SH AH N
OPTIO	AA P T IY OW
OPULENT	AA P Y AH L AH N T
OR	AO R
OR(2)	ER
ORATION	AO R EY SH AH N
ORATOR	AO R AH T ER
ORB	AO R B
ORBITAL	AO R B AH T AH L
ORDER	AO R D ER
ORDINATION	AO R D AH N EY SH AH N
ORHA	AO R AH
ORNATE	AO R N EY T
ORPHIEL	AO R F IY L
ORPHION	AO R F IY AH N
ORTANNU	AO R T AE N UW
ORTANNUS	AO R T AE N AH S
OSTENTATIOUS	AA S T AH N T EY SH AH S
OSTRACIZE	AO S T R AH S AY Z
OSWIN	AA S W IH N
OTTO	AA T OW
OUBLIETTE	AW B L AY EH T
OUT	AW T
OUTFLANK	AW T F L AE NG K
OUTNEGOTIATE	AW T N IH G OW SH IY EY T
OUTPOST	AW T P OW S T
OVER	OW V ER
OVERLORD	OW V ER L AO R D
OVERRUN	OW V ER R AH N
OXTET	AA K S T AH T
OZMO	AA Z M OW
PACK	P AE K
PADDY	P AE D IY
PADDY-EVIL	P AE D IY IY V AH L
PAIN	P EY N
PAINMAIL	P EY N M EY L
PALE	P EY L
PANDEMONIUM	P AE N D IH M OW N IY AH M
PANDULF	P AE N D AH L F
PANPACA	P AE N P AH K AH
PARAGUARDIAN	P AA R AH G AA R D IY AH N
PARTICLE	P AA R T AH K AH L
PARTICLE(2)	P AA R T IH K AH L
PAST	P AE S T
PATRICIAN	P AH T R IH SH AH N
PATRIZATE	P AE T R AH Z EY T
PATRONAGE	P AE T R AH N IH JH
PATRONAGE(2)	P EY T R AH N AH JH
PATRONAGE(3)	P EY T R AH N IH JH
PAW	P AO
PAWN	P AO N
PAX	P AE K S
PEACE	P IY S
PEARL	P ER L
PELF	P EH L F
PENNY	P EH N IY
PERILOUS	P EH R AH L AH S
PERPLEXING	P ER P L EH K S IH NG
PERSISTENCE	P ER S IH S T AH N S
PESTERGROVE	P EH S T ER G R OW V
PESTERING	P EH S T ER IH NG
PESTILENCE	P EH S T AH L AH N S
PETE	P IY T
PHALANX	F EY L AE NG K S
PHANTOM	F AE N T AH M
PHANTOM(2)	F AE N AH M
PHASE	F EY Z
PHEROMONES	F EH R AH M OW N Z
PHILO	F IY L OW
PHILO-EVIL	F IY L OW IY V AH L
PHILOPHOSAURUS	F AH L AA F AH S EY Y AH R AH S
PHILOSOPHER	F AH L AA S AH F ER
PHLOXEM	F L AA K S AH M
PHOENIX	F IY N IH K S
PHOSPHORUS	F AA S F ER AH S
PHOTIC	F AA T AH K
PHOTON	F OW T AA N
PHYLYX	F IH L AH K S
PHYSALOHA	F AH S AE L AH HH AH
PHYSICUS	F AY Z IH S AH S
PI	P AY
PICAROON	P IH K AH R UW N
PILE	P AY L
PILLAGE	P IH L IH JH
PINCERATOR	P IH N S AH R EY T AH R
PINGLE	P IH N G AH L
PIP	P IH P
PIPES	P AY P S
PIRANHA	P IH R AE N HH AH
PISMIRE	P IH Z M AY R
PIT	P IH T
PITLORD	P IH T L AO R D
PIXIE	P IH K S IY
PIXIES	P IH K S IY Z
PLACE	P L EY S
PLAGUE	P L EY G
PLAN	P L AE N
PLANET	P L AE N AH T
PLANK	P L AE NG K
PLANT	P L AE N T
PLASMA	P L AE Z M AH
PLASMATE	P L AE Z AH M AH T
PLATFORM	P L AE T F AO R M
PLATOPELTA	P L AE T AH P EH L T AH
PLAY	P L EY
PLEBEIANS	P L AH B IY AH N Z
PLUNDER	P L AH N D ER
POCKET	P AA K AH T
POD	P AA D
POEM	P OW AH M
POISON	P OY Z AH N
POKE	P OW K
POLICY	P AA L AH S IY
POLLIASAURUS	P AA L IY AH S EY Y AH R AH S
POLTERGEIST	P OW L T ER G AY S T
POMPITUS	P AA M P AH T AH S
PORCUPINE	P AO R K Y AH P AY N
PORPOISES	P AO R P AH S AH Z
PORTAL	P AO R T AH L
PORTALMONGER	P OW R T AH L M AH NG G ER
POS	P AA S
POS(2)	P IY OW EH S
POSITRON	P AA Z AH T R AA N
POTION	P OW SH AH N
POUND	P AW N D
POUR	P AO R
POVERTY	P AA V ER T IY
POWER	P AW ER
PRAECO	P R IY K OW
PRAEFECTUS	P R IY F EH K T AH S
PRAETOR	P R IY T ER
PREP	P R EH P
PRESCRIPTIVE	P R IY S K R IH P T IH V
PRESERVATION	P R EH Z ER V EY SH AH N
PRESS	P R EH S
PRESSURE	P R EH SH ER
PREY	P R EY
PRIDE	P R AY D
PRIEST	P R IY S T
PRIMAL	P R AY M AH L
PRIMUS	P R AY M AH S
PRINCE	P R IH N S
PRINCIPLE	P R IH N S AH P AH L
PROBE	P R OW B
PROCLAMATION	P R AA K L AH M EY SH AH N
PROF	P R AA F
PROFESSOR	P R AH F EH S ER
PROGRAM	P R OW G R AE M
PROJECT	P R AA JH EH K T
PROLIFERATOR	P R AH L IH F ER AH T ER
PROMISED	P R AA M AH S T
PROPAGANDA	P R AA P AH G AE N D AH
PROPHET	P R AA F AH T
PROSPECTOR	P R AO S P EH K T ER
PROTECT	P R AH T EH K T
PROTECTRIX	P R OW T EH K T R AH K S
PROVOKER	P R AH V OW K ER
PSIONIC	S AY AH N AH K
PSYCHIC	S AY K IH K
PULL	P UH L
PULPATE	P AH L P AH T
PULSE	P AH L S
PUNCH	P AH N CH
PUNCTUATED	P AH NG K CH UW EY T IH D
PUPGRADE	P AH P G R EY D
PURGE	P ER JH
PURIFIER	P Y UH R AH F AY ER
PURIFY	P Y UH R AH F AY
PURPLE	P ER P AH L
PUZZLING	P AH Z AH L IH NG
PUZZLING(2)	P AH Z L IH NG
PYR0	P IY W AY AA R Z IY R OW
Q	K Y UW
QINCAN	K IH NG K AH N
QINCANS	K IH NG K AH N Z
QUADRACORDER	K W AA D R AH K AO R D AH R
QUANT	K W AE N T
QUANTUM	K W AA N T AH M
QUEEN	K W IY N
QUEST	K W EH S T
QUESTOR	K W EH S T ER
QUICKSAND	K W IH K S AE N D
QUIET	K W AY AH T
QUINTINA	K W IY N T IY N AH
QUINTRINO	K W IH N T R AH N OW
QUIXO	K W IH K S OW
QUIXXLE	K W IH K S AH L
QYXXLYX	K IH K S L AH K S
R	AA R
RAD	R AE D
RADIANT	R EY D IY AH N T
RAGNAROK	R AE G N AH R AH K
RAGWARG	R AE G W AH R G
RAIDER	R EY D ER
RAIDING	R EY D IH NG
RAKUZEL	R AE K Y UW Z AH L
RAKUZELS	R AE K Y UW Z AH L Z
RAMPAGING	R AE M P EY JH IH NG
RAMPAGING(2)	R AE M P AH JH IH NG
RANDOM	R AE N D AH M
RANSACK	R AE N S AE K
RANSOM	R AE N S AH M
RANT	R AE N T
RAPID	R AE P AH D
RAPID(2)	R AE P IH D
RAPSCAL	R AE P S AH L
RAPTOR	R AE P T ER
RAT	R AE T
RAY	R EY
RAZING	R EY Z IH NG
REACH	R IY CH
REACTION	R IY AE K SH AH N
REAP	R IY P
REAPER	R IY P ER
REASSEMBLING	R IY AH S EH M B AH L IH NG
REAVER	R IY V ER
REBEL	R EH B AH L
REBEL(2)	R IH B EH L
RECALL	R IY K AO L
RECALL(2)	R IH K AO L
RECKLESS	R EH K L AH S
RECLAIMED	R IY K L EY M D
RECORDED	R AH K AO R D AH D
RECORDED(2)	R IH K AO R D IH D
RECRUIT	R AH K R UW T
RECRUIT(2)	R IH K R UW T
RECRUIT(3)	R IY K R UW T
RECRUITER	R IH K R UW T ER
RECRUITING	R AH K R UW T IH NG
RECRUITING(2)	R IH K R UW T IH NG
RECRUITING(3)	R IY K R UW T IH NG
RECRUITMENT	R AH K R UW T M AH N T
RECRUITMENT(2)	R IH K R UW T M AH N T
RECRUITMENT(3)	R IY K R UW T M AH N T
RECYCLE	R IY S AY K AH L
RED	R EH D
REDACTED	R IH D AE K T IH D
REDEEMED	R IH D IY M D
REDHAND	R EH D HH AE N D
REDLOCK	R EH D L AA K
REDRESS	R IY D R EH S
REFLECTOR	R IH F L EH K T ER
REFRAIN	R IH F R EY N
REGISTRY	R EH JH IH S T R IY
REGRETTABLE	R IH G R EH T AH B AH L
REGROWTH	R IY G R OW TH
RELEASE	R IY L IY S
RELENTLESS	R IH L EH N T L IH S
RELIC	R EH L IH K
RELIQUARY	R AH L IH K W AH R IY
REMIEL	R AH M IY L
REMINDER	R IY M AY N D ER
REMOTE	R IH M OW T
REMOTE(2)	R IY M OW T
RENEWED	R IH N UW D
RENEWED(2)	R IY N UW D
REPLAY	R IY P L EY
REPLICATOR	R EH P L IH K EY T ER
REQUEST	R IH K W EH S T
REQUEST(2)	R IY K W EH S T
RESEARCH	R IY S ER CH
RESEARCHER	R IY S ER CH ER
RESONATOR	R EH Z AH N AH T ER
RESTRINGUNTUS	R IH S T R IH N G AH N T AH S
RESURGENCE	R IY S ER JH AH N S
RETIREMENT	R IY T AY ER M AH N T
RETIREMENT(2)	R IH T AY ER M AH N T
RETRIBUTION	R EH T R AH B Y UW SH AH N
RETURNING	R IH T ER N IH NG
RETURNING(2)	R IY T ER N IH NG
REVENGE	R IY V EH N JH
REVERED	R IH V IH R D
REVERSE	R IH V ER S
REVERSE(2)	R IY V ER S
REVNA	R IH V N AA
REVO	R AH V OW
REVOLUTION	R EH V AH L UW SH AH N
REX	R EH K S
RHETOR	R IY T AH R
RICHES	R IH CH AH Z
RICHES(2)	R IH CH IH Z
RIDER	R AY D ER
RIG	R IH G
RIGGED	R IH G D
RIGHT	R AY T
RIKK	R IH K
RING	R IH NG
RITUAL	R IH CH UW AH L
RIVE	R AY V
RIVER	R IH V ER
RIZZO	R IH Z OW
ROAD	R OW D
ROCK	R AA K
ROCKET	R AA K AH T
ROCKETEER	R AA K AH T IH R
ROD	R AA D
ROGUE	R OW G
RONNIE	R AA N IY
ROOFTOP	R UW F T AA P
ROSTRUM	R AA S T R AH M
ROTGRUB	R AA T G R AH B
ROTHAIS	R AA T HH EY Z
ROUND	R AW N D
ROUTINE	R UW T IY N
ROVER	R OW V ER
ROWDY	R AW D IY
ROXADOR	R AA K S AH D AH R
RUIN	R UW AH N
RUIN(2)	R UW IH N
RUINS	R UW AH N Z
RUINS(2)	R UW IH N Z
RUN	R AH N
RUPTURE	R AH P CH ER
RUSTGNAWER	R AH S T N AO ER
RUSTMISER	R AH S T M AH S AH R
RUTH	R UW TH
SABOTAGE	S AE B AH T AA ZH
SACK	S AE K
SACRIFICE	S AE K R AH F AY S
SACRIFICIAL	S AE K R AH F IH SH AH L
SACRO	S AE K R OW
SAFE	S EY F
SAFEGUARD	S EY F G AA R D
SAFETY	S EY F T IY
SAGITTARIIS	S AH JH IH T AE R IY AH S
SALT	S AO L T
SAMPLE	S AE M P AH L
SAMRA	S AE M R AH
SANCTUM	S AE NG K T AH M
SANDALS	S AE N D AH L Z
SANDHOPPER	S AE N D HH AA P ER
SANITATION	S AE N AH T EY SH AH N
SANITATION(2)	S AE N IH T EY SH AH N
SARGASSA	S AA R G AE S AH
SARGASSA-EVIL	S AA R G AE S AH IY V AH L
SARIEL	S AH R IY L
SAURARIUM	S AH R AE R IY AH M
SAURIAN	S EY Y UH R IY AH N
SAURIANA	S AH R IY AH N AH
SAUROPOD	S AO R AH P AH D
SAURUS	S EY Y AH R AH S
SAURY	S AO R IY
SAVAGE	S AE V AH JH
SAVAGE(2)	S AE V IH JH
SAVE	S EY V
SAY	S EY
SCALE	S K EY L
SCARRED	S K AA R D
SCHOLAR	S K AA L ER
SCHOOL	S K UW L
SCI	S IY
SCI(2)	EH S S IY AY
SCIENCE	S AY AH N S
SCIENTIFICAL	S AY AH N T IH F IH K AH L
SCIENTISTS	S AY AH N T IH S T S
SCIENTISTS(2)	S AY N T IH S T S
SCIENTISTS(3)	S AY N T IH S
SCIENTISTS(4)	S AY AH N T IH S
SCOOP	S K UW P
SCOOPED	S K UW P T
SCOUT	S K AW T
SCOWLY	S K AW L IY
SCRAMBLER	S K R AE M B AH L ER
SCRAPPER	S K R AE P ER
SCRAPSCROUNGER	S K R AE P S K R AW N JH ER
SCREAMING	S K R IY M IH NG
SCREECHBOMB	S K R IY CH B AA M
SCRIVENER	S K R IH V N ER
SCROLL	S K R OW L
SCUTUM	S K Y UW T AH M
SCYLLA	S IH L AH
SCYPHOS	S IH F AH Z
SEA	S IY
SEABORG	S IY B AH R G
SEABRINGER	S IY B R IH NG ER
SEAS	S IY Z
SEASON	S IY Z AH N
SECRETS	S IY K R IH T S
SECURI	S EH K Y AH R IY
SEED	S IY D
SEEKER	S IY K ER
SEISMO	S AY Z M OW
SELECTION	S AH L EH K SH AH N
SELECTIVE	S AH L EH K T IH V
SELF	S EH L F
SELWYN	S EH L W IH N
SEMPER	S EH M P AH R
SENATOR	S EH N AH T ER
SENESCHAL	S AH N EH S AH L
SENSOR	S EH N S ER
SEPDIA	S EH P D IY AH
SEQUIS	S IY K W IY Z
SERAPHIC	S EH R AH F AH K
SERGEANT	S AA R JH AH N T
SERUM	S IH R AH M
SGS	EH S JH IY S
SHADOW	SH AE D OW
SHADOWS	SH AE D OW Z
SHADOWSAURUS	SH AE D AH S EY Y AH R AH S
SHADOWSMITH	SH AE D OW S M IH TH
SHAFFLES	SH AE F AH L Z
SHAKEDOWN	SH EY K D AW N
SHAMAN	SH EY M AH N
SHARD	SH AA R D
SHARK	SH AA R K
SHARK-EVIL	SH AA R K IY V AH L
SHATTER	SH AE T ER
SHATTERED	SH AE T ER D
SHELL	SH EH L
SHERMAN	SH ER M AH N
SHIELD	SH IY L D
SHIELDING	SH IY L D IH NG
SHIFT	SH IH F T
SHIFTING	SH IH F T IH NG
SHIGZISO	SH IH G Z AH S OW
SHIP	SH IH P
SHISNYASI	SH IH Z N AY AH S IY
SHIZYOKU	SH AH Z AY AH K UW
SHOCK	SH AA K
SHOCKWORM	SH AA K W ER M
SHOES	SH UW Z
SHOOLER	SH UW L AH R
SHOPPING	SH AA P IH NG
SHORELINE	SH AO R L AY N
SHORTY	SH AO R T IY
SHORTYS	SH AO R T IY Z
SHOULDER	SH OW L D ER
SHREWD	SH R UW D
SHRIX	SH R IH K S
SIBYL	S IH B AH L
SIC	S IH K
SIGHT	S AY T
SIGIL	S IH JH AH L
SIGNAL	S IH G N AH L
SILENCE	S AY L AH N S
SILENT	S AY L AH N T
SILVER	S IH L V ER
SILVERTOOTH	S IH L V ER T UW TH
SIMPSON	S IH M P S AH N
SIMPSON-EVIL	S IH M P S AH N IY V AH L
SINDER	S AY N D AH R
SINESTRA	S AH N EH S T R AH
SINK	S IH NG K
SIR	S ER
SIREN	S AY R AH N
SKALD	S K AE L D
SKELETON	S K EH L AH T AH N
SKIPPY	S K IH P IY
SKIRMISHER	S K ER M IH SH ER
SKIXUNO	S K IH K S Y UW N OW
SKULLBACK	S K AH L B AE K
SKULLION	S K AH L Y AH N
SKULLS	S K AH L S
SKULLS(2)	S K AH L Z
SKYBOOSTER	S K AY B UW S T ER
SKöLL	EH S K EY EH L
SLAM	S L AE M
SLEEP	S L IY P
SLIMY	S L AY M IY
SLOPPY	S L AA P IY
SLOTH	S L OW TH
SLRS	EH S EH L AA R S
SMAAASH	S M AA AH SH
SMARTFIST	S M AA R T F IH S T
SMARTYPANTS	S M AA R T IY P AE N T S
SMILING	S M AY L IH NG
SMITE	S M AY T
SMITH	S M IH TH
SMOKO	S M AA K OW
SMYTH	S M AY TH
SMYTH(2)	S M IH TH
SNAG	S N AE G
SNAGLET	S N AE G L AH T
SNAGS	S N AE G Z
SNARETTE	S N EH R EH T
SNATCHER	S N AE CH ER
SNEKLIFTER	S N EH K L IH F T AH R
SNIB	S N IH B
SNIFFER	S N IH F ER
SNUDGE	S N AH JH
SNUFFLEGATOR	S N AH F L EH G AH T ER
SO	S OW
SOBOGGS	S AA B AH G Z
SOCRATEROSAURUS	S AA K R AH T EH R AH S EY Y AH R AH S
SOFT	S AA F T
SOFT(2)	S AO F T
SOLDIERS	S OW L JH ER Z
SOLEFT	S AA L AH F T
SONG	S AO NG
SOPHISTRY	S AH F IH S T R IY
SORRY	S AA R IY
SOTO	S OW T OW
SOUL	S OW L
SOULKEEPER	S OW L K IY P ER
SOULS	S OW L Z
SOUND	S AW N D
SOW	S AW
SOW(2)	S OW
SPACE	S P EY S
SPANGLER	S P AE NG G AH L ER
SPANGLER(2)	S P AE NG G L ER
SPARKFIST	S P AA R K F IH S T
SPARTASAUR	S P AA R T AH S AH R
SPEARS	S P IH R Z
SPECIAL	S P EH SH AH L
SPECIALIST	S P EH SH AH L IH S T
SPECTER	S P EH K T ER
SPECTRAL	S P EH K T R AH L
SPEED	S P IY D
SPIDER	S P AY D ER
SPIKE	S P AY K
SPIRAL	S P AY R AH L
SPIRIT	S P IH R AH T
SPIRIT(2)	S P IH R IH T
SPIRITS	S P IH R IH T S
SPLINTER	S P L IH N T ER
SPOILS	S P OY L Z
SPOREGORGER	S P OW R G AO R JH ER
SPOREGORGER-EVIL	S P OW R G AO R JH ER IY V AH L
SPREE	S P R IY
SPRING	S P R IH NG
SPRING(2)	S P ER IH NG
SPYMASTER	S P AY M AE S T ER
SPYYYDER	S P AY AY AY D AH R
SQUADRON	S K W AA D R AH N
SQUAWKER	S K W AO K ER
SQUIRE	S K W AY R
STAFF	S T AE F
STAKES	S T EY K S
STAMPEDE	S T AE M P IY D
STANDARD	S T AE N D ER D
STANDARDIZED	S T AE N D ER D AY Z D
STAR	S T AA R
STARS	S T AA R Z
STARSONG	S T AA R S AO NG
STASH	S T AE SH
STATE	S T EY T
STATIC	S T AE T IH K
STATION	S T EY SH AH N
STAUNCH	S T AO N CH
STEADFAST	S T EH D F AE S T
STEALER	S T IY L ER
STEALTH	S T EH L TH
STEALTHSTER	S T EH L TH S T ER
STEELHEART	S T IY L HH AA R T
STEELHEART-EVIL	S T IY L HH AA R T IY V AH L
STEM	S T EH M
STENOPIUS	S T AH N AA P AY AH S
STEP	S T EH P
STEWARD	S T UW ER D
STILT	S T IH L T
STIMRAGER	S T IH M R AH JH AH R
STING	S T IH NG
STIR	S T ER
STIRRING	S T ER IH NG
STOCKPILE	S T AA K P AY L
STOMP	S T AA M P
STONE	S T OW N
STOOD	S T UH D
STORM	S T AO R M
STRANGE	S T R EY N JH
STRATOSMACK	S T R AH T AA Z M AH K
STREKE	S T R IY K
STRENGTH	S T R EH NG K TH
STRENGTH(2)	S T R EH NG TH
STRIKE	S T R AY K
STRONGER	S T R AO NG G ER
STUNNER	S T AH N ER
SU	S UW
SUBDUE	S AH B D UW
SUBJECT	S AH B JH EH K T
SUBJECT(2)	S AH B JH IH K T
SUBMERSIBLE	S AH B M ER S IH B AH L
SUBMERSIVE	S AH B M EH R Z AH V
SUBORDINATION	S AH B AO R D AH N EY SH AH N
SUBSIDIES	S AH B S AH D IY Z
SUBSIDIES(2)	S AH B S IH D IY Z
SUBTLE	S AH T AH L
SUCCUBUS	S AH K Y UW B AH S
SUCKER	S AH K ER
SUIT	S UW T
SULLIVAN	S AH L AH V AH N
SULLIVAN(2)	S AH L IH V AH N
SUMMONER	S AH M AH N ER
SUNK	S AH NG K
SUPPORT	S AH P AO R T
SURGE	S ER JH
SURVEY	S ER V EY
SUSPENDED	S AH S P EH N D AH D
SUSPENDED(2)	S AH S P EH N D IH D
SUSURRUS	S UW S AH R AH S
SUTTERKIN	S AH T AH R K AH N
SV3	EH S V IY TH R IY
SVEND	S V EH N D
SWALLOW	S W AA L OW
SWALLOW(2)	S W AO L OW
SWAP	S W AA P
SWARM	S W AO R M
SWEEP	S W IY P
SWEVEN	S W IY V AH N
SWEVEN-EVIL	S W IY V AH N IY V AH L
SWIM	S W IH M
SWINDLE	S W IH N D AH L
SWIRL	S W ER L
SWITCH	S W IH CH
SWOPPER	S W AA P AH R
SYMON	S IH M AH N
SYMPOSIUM	S IH M P OW Z IY AH M
SYNAN	S AY N AH N
SYNAN-EVIL	S AY N AH N IY V AH L
SYPHON	S AY F AH N
SYSTEM	S IH S T AH M
T	T IY
T3R	T IY TH R IY AA R
TABER	T EY B ER
TABLE	T EY B AH L
TABRIS	T AE B R IY Z
TACHYON	T AE CH AY AH N
TACTICAL	T AE K T IH K AH L
TAKE	T EY K
TAL	T AA L
TALENT	T AE L AH N T
TALKING	T AO K IH NG
TALLMINDED	T AO L M AY N D IH D
TALMAGE	T AE L M IH JH
TAMER	T EY M ER
TANGAIKA	T AE N G EY K AH
TANIWHA	T AH N IH W HH AH
TANIWHA-EVIL	T AH N IH W HH AH IY V AH L
TANK	T AE NG K
TANTADLIN	T AE N T AE D L AH N
TAR	T AA R
TAUTAU	T AO T AH
TAXING	T AE K S IH NG
TE	T IY
TEAM	T IY M
TEAMWORK	T IY M W ER K
TECHIVORE	T EH K AH V AH R
TECHNICIAN	T EH K N IH SH AH N
TECHNO	T EH K N OW
TECHNOBABBLE	T EH K N AH B AH B AH L
TECTONIC	T EH K T AA N IH K
TELEPORTER	T EH L AH P OW R T ER
TELIGA	T EH L AH G AH
TEMPORAL	T EH M P ER AH L
TEMPTING	T EH M P T IH NG
TENDRILS	T EH N D R AH L Z
TENTACLID	T EH N T IH K AH L AH D
TENTACUS	T EH N T AH S AH S
TERATO	T EH R AH T OW
TERMS	T ER M Z
TERRIBLE	T EH R AH B AH L
TERROR	T EH R ER
TERRORDACTYL	T EH R ER D AE K T AH L
TERTIATE	T AH R T AY EY T
TESTING	T EH S T IH NG
TEZMAL	T EH Z M AH L
THALASSOPHOBIA	TH AH L AE S AH F OW B IY AH
THAT	DH AE T
THAT(2)	DH AH T
THE	DH AH
THE(2)	DH IY
THEM	DH EH M
THEM(2)	DH AH M
THEORIST	TH IY ER IH S T
THEORY	TH IH R IY
THEORY(2)	TH IY ER IY
THERAPY	TH EH R AH P IY
THERE	DH EH R
THERO	TH EH R OW
THEY	DH EY
THEY'RE	DH EH R
THIEF	TH IY F
THIEVERY	TH IY V ER IY
THIEVES	TH IY V Z
THIN	TH IH N
THINGAMABOB	TH IH NG AH M AH B AA B
THINK	TH IH NG K
THINKDRONE	TH IH NG K D R OW N
THORIUM	TH AA R IY AH M
THRAX	TH R AE K S
THREE	TH R IY
THRONE	TH R OW N
THROWING	TH R OW IH NG
THUNDERTOW	TH AH N D ER T OW
TIDAL	T AY D AH L
TIDE	T AY D
TIGER	T AY G ER
TIME	T AY M
TIMEHOG	T AY M HH AA G
TIMEQUAKE	T AY M K W EY K
TIMETRAVELLER	T AY M T R AE V AH L ER
TIMOTI	T IH M AH T IY
TINK	T IH NG K
TINKER	T IH NG K ER
TIRELESS	T AY ER L AH S
TITAN	T AY T AH N
TITANIC	T AY T AE N IH K
TITANS	T AY T AH N Z
TO	T UW
TO(2)	T IH
TO(3)	T AH
TOAD	T OW D
TOCSIN	T AA K S AH N
TOES	T OW Z
TOGETHER	T AH G EH DH ER
TOGNATH	T AA G N AH TH
TOKEN	T OW K AH N
TOLAS	T AA L AH Z
TOMWA	T AA M W AH
TOO	T UW
TORCHTOOTH	T AO R CH T UW TH
TORVUS	T AO R V AH S
TOTAL	T OW T AH L
TOUCH	T AH CH
TOURIST	T UH R AH S T
TOURIST(2)	T UH R IH S T
TOXICUDA	T AA K S AH K Y UW D AH
TRACKER	T R AE K ER
TRADE	T R EY D
TRADER	T R EY D ER
TRADING	T R EY D IH NG
TRAINER	T R EY N ER
TRAINING	T R EY N IH NG
TRAITOR	T R EY T ER
TRANSITORY	T R AE N Z AH T AO R IY
TRANSLATOR	T R AE N S L EY T ER
TRANSLATOR(2)	T R AE N Z L EY T ER
TRANSPONDER	T R AE N S P AA N D ER
TRANSPORTER	T R AE N S P AO R T ER
TRANSPOSITION	T R AE N S P AH Z IH SH AH N
TRAP	T R AE P
TRAY	T R EY
TREASURE	T R EH ZH ER
TREE	T R IY
TREMOR	T R EH M ER
TRENCH	T R EH N CH
TRIAL	T R AY AH L
TRIAL(2)	T R AY L
TRIBUNE	T R IH B Y UW N
TRIBUTE	T R IH B Y UW T
TRICERIAN	T R AH S IY R IY AH N
TRICKLE	T R IH K AH L
TRIGON	T R IH G AO N
TRIMBLE	T R IH M B AH L
TRINKET	T R IH NG K AH T
TRIUMPH	T R AY AH M F
TROJAN	T R OW JH AH N
TROLL	T R OW L
TROOP	T R UW P
TROOPER	T R UW P ER
TROUBLE	T R AH B AH L
TRUEBARU	T R UW EH B AH R UW
TRUST	T R AH S T
TRUTH	T R UW TH
TRYSKA	T R IH S AH
TRYSKA-EVIL	T R IH S AH IY V AH L
TULLIA	T AH L IY AH
TUNK	T AH NG K
TUNNELER	T AH N AH L ER
TURNKEY	T ER N K IY
TWICE	T W AY S
TWIN	T W IH N
TWO	T UW
TYA	T AY AH
TYRANNOSAURUS	T IH R AE N AH S AO R AH S
TYXL	T IH K S L
U	Y UW
ULFBERHT	AH L F B AH R T
ULTRA	AH L T R AH
ULYQ	Y UW L AH K
UMBRA	AH M B R AH
UNCHARTED	AH N CH AA R T IH D
UNCOMMON	AH N K AA M AH N
UNDAGNATHUS	AH N D AE G N AH TH AH S
UNDAGNATHUS-EVIL	AH N D AE G N AH TH AH S IY V AH L
UNDER	AH N D ER
UNGUARDED	AH N G AA R D IH D
UNGUIS	AH N G AY Z
UNIFIER	Y UW N AH F AY ER
UNIT	Y UW N AH T
UNIT(2)	Y UW N IH T
UNITED	Y UW N AY T AH D
UNITED(2)	Y UW N AY T IH D
UNITY	Y UW N AH T IY
UNITY(2)	Y UW N IH T IY
UNIVERSAL	Y UW N AH V ER S AH L
UNIVERSE	Y UW N AH V ER S
UNLOCKED	AH N L AA K T
UNNATURAL	AH N N AE CH ER AH L
UNSUSPECTING	AH N S AH S P EH K T IH NG
UNTAMED	AH N T EY M D
UP	AH P
UPLINK	UW P L IH NG K
URCHIN	ER CH AH N
URCHIN-EVIL	ER CH AH N IY V AH L
URIEN	Y UH R AY AH N
URSO	ER S OW
URSO-EVIL	ER S OW IY V AH L
UXLYX	AH K S L AH K S
UZYANE	Y UW Z AY EY N
V3	V IY TH R IY
VAC	V AE K
VAL	V AE L
VALDR	V AE L D R
VALMART	V AE L M AH R T
VALOOCANTH	V AE L AH K AH N TH
VANDALIZE	V AE N D AH L AY Z
VANITY	V AE N AH T IY
VANITY(2)	V AE N IH T IY
VAPORS	V EY P ER Z
VATMINDER	V AE T M AY N D AH R
VAULT	V AO L T
VAULTKEEPER	V AO L T K IY P ER
VAULTS	V AO L T S
VEEMOS	V IY M AH Z
VELUM	V EH L AH M
VENATOR	V IY N EY T AH R
VENDOR	V EH N D ER
VENOM	V EH N AH M
VEROKTER	V AH R AA K T AH R
VESPILON	V EH S AH L AH N
VEYLAN	V EY L AH N
VEZYMA	V EH Z AH M AH
VIEW	V Y UW
VIGOR	V IH G ER
VINDA	V IH N D AH
VINEAPPLE	V AY N AE P AH L
VINES	V AY N Z
VINUM	V IH N AH M
VIRTUOUS	V ER CH UW AH S
VIRUS	V AY R AH S
VISIBLE	V IH Z AH B AH L
VITA	V AY T AH
VITA-EVIL	V AY T AH IY V AH L
VOICE	V OY S
VOID	V OY D
VOW	V AW
VULKA	V AH L K AH
WAIL	W EY L
WAIMARE	W EY M AH R
WAKING	W EY K IH NG
WALK	W AO K
WALK(2)	W AA K
WALL	W AO L
WALLS	W AO L Z
WAR	W AO R
WARCHEST	W AO R CH EH S T
WARDRUMMER	W AO R D R AH M ER
WARK	W AO R K
WARP	W AO R P
WARRIOR	W AO R IY ER
WARRIOR(2)	W AO R Y ER
WARRIORS	W AO R IY ER Z
WARRIORS(2)	W AO R Y ER Z
WARSONG	W AO R S AO NG
WASHED	W AA SH T
WASTE	W EY S T
WATCH	W AA CH
WATCH(2)	W AO CH
WATER	W AO T ER
WAVE	W EY V
WAY	W EY
WE	W IY
WEAK	W IY K
WEAPONSMITH	W EH P AH N S M IH TH
WEASAND	W IY S AH N D
WHAT	W AH T
WHAT(2)	HH W AH T
WHEKE	W IY K
WHIRLPOOL	W ER L P UW L
WHIRLPOOL(2)	HH W ER L P UW L
WHISPER	W IH S P ER
WHISPER(2)	HH W IH S P ER
WHISPERING	W IH S P ER IH NG
WHISPERING(2)	HH W IH S P ER IH NG
WHISPERS	W IH S P ER Z
WHISPERS(2)	HH W IH S P ER Z
WHISTLING	W IH S L IH NG
WHISTLING(2)	HH W IH S L IH NG
WHITE	W AY T
WHITE(2)	HH W AY T
WHO	HH UW
WHOLE	HH OW L
WIDESPREAD	W AY D S P R EH D
WIDGET	W IH JH IH T
WIKOLIA	W AH K OW L Y AH
WIKOLIA-EVIL	W AH K OW L Y AH IY V AH L
WILD	W AY L D
WILDS	W AY L D Z
WILLA	W IH L AH
WILLA-EVIL	W IH L AH IY V AH L
WIN	W IH N
WIPE	W AY P
WITCH	W IH CH
WITH	W IH DH
WITH(2)	W IH TH
WOLF	W UH L F
WONDER	W AH N D ER
WOODS	W UH D Z
WORD	W ER D
WORK	W ER K
WORKS	W ER K S
WORLD	W ER L D
WORM	W ER M
WORMHOLE	W ER M HH AO L
WRATH	R AE TH
WREATHED	R IY DH D
WRETCHED	R EH CH IH D
WRISTCLOCKS	R IH S T K L AA K S
XALVADOR	Z AE L V AH D AH R
XANTHYX	Z AE N TH AH K S
XENO	Z EH N OW
XENOS	Z IY N OW Z
XENOTRAINING	Z EH N AH T R EY N AH NG
YANTHI	Y AE N TH IY
YANTZEE	Y AE N T S IY IY
YO	Y OW
YOU	Y UW
YOUNGEST	Y AH NG G AH S T
YOUR	Y AO R
YOUR(2)	Y UH R
YSHI	Y SH IY
YURK	Y AH R K
YXILI	Y K S IH L IY
YXILO	Y K S IH L OW
YXILX	Y K S IH L K S
YXL	Y K S L
YXLIX	Y K S L IH K S
YXLYX	Y K S L IH K S
YZPHYZ	Y Z F IH Z
Z	Z IY
ZA	Z AA
ZAKIEL	Z EY K IY L
ZAP	Z AE P
ZAREK	Z AA R EH K
ZEALOT	Z EH L AH T
ZEALOT(2)	Z IY L AH T
ZENZIZENZIZENZIC	Z EH N Z AH Z EH N Z AH Z AH N Z AH K
ZEPHON	Z EH F AH N
ZIZOK	Z IH Z AH K
ZOOKEEPER	Z UW K IY P ER
ZORG	Z AO R G
ZYSYSYX	Z IH S AH S AH K S
ZYTAR	Z AY T AH R
ZYX	Z IH K S
ZYZZIX	Z IH Z AH K S
